1-1-1-1-1-1-1-1-1-1-10-20-30-25-12-9
1-0-0-0-0-0-0-0-0-1-10-20-30-25-12-9
1-0-0-0-0-0-0-0-0-1-10-20-30-25-12-9
1-0-0-0-0-0-0-0-0-1-10-20-30-25-12-9
1-0-0-2-2-2-2-0-0-1-10-20-30-25-12-9
1-0-0-2-2-2-2-0-0-1-10-20-30-25-12-9
1-0-0-0-0-0-0-0-0-1-10-20-30-25-12-9
1-1-1-1-1-1-1-1-1-1-10-20-30-25-12-9
1-0-0-2-2-2-2-0-0-1-10-20-30-25-12-9
1-0-0-2-2-2-2-0-0-1-10-20-30-25-12-9
1-0-0-2-2-2-2-0-0-1-10-20-30-25-12-9
1-0-0-2-2-2-2-0-0-1-10-20-30-25-12-9